{
  "name": "JID本社 3F - 役員フロア",
  "width": 22,
  "height": 16,
  "spawn_point": {
    "x": 11,
    "y": 13
  },
  "tiles": [
    [0, 0, 0, 0, 0, 0, 0, 0, 0, 0, 0, 0, 0, 0, 0, 0, 0, 0, 0, 0, 0, 0],
    [0, 1, 1, 1, 1, 1, 1, 0, 0, 0, 1, 1, 1, 0, 0, 0, 1, 1, 1, 1, 1, 0],
    [0, 1, 5, 5, 5, 5, 1, 0, 0, 0, 1, 1, 1, 0, 0, 0, 1, 5, 5, 5, 1, 0],
    [0, 1, 5, 5, 5, 5, 1, 2, 0, 0, 1, 1, 1, 0, 0, 2, 1, 5, 5, 5, 1, 0],
    [0, 1, 5, 5, 5, 5, 1, 0, 0, 0, 1, 1, 1, 0, 0, 0, 1, 5, 5, 5, 1, 0],
    [0, 1, 1, 1, 1, 1, 1, 0, 0, 0, 1, 1, 1, 0, 0, 0, 1, 1, 1, 1, 1, 0],
    [0, 1, 1, 1, 1, 1, 1, 0, 0, 0, 1, 1, 1, 0, 0, 0, 1, 1, 1, 1, 1, 0],
    [0, 0, 0, 0, 0, 0, 0, 0, 0, 0, 1, 1, 1, 0, 0, 0, 0, 0, 0, 0, 0, 0],
    [0, 1, 1, 1, 1, 1, 1, 1, 1, 1, 4, 4, 4, 1, 1, 1, 1, 1, 1, 1, 1, 0],
    [0, 1, 1, 1, 1, 1, 1, 1, 1, 1, 4, 4, 4, 1, 1, 1, 1, 1, 1, 1, 1, 0],
    [0, 1, 1, 1, 1, 1, 1, 1, 1, 1, 4, 4, 4, 1, 1, 1, 1, 1, 1, 1, 1, 0],
    [0, 1, 1, 1, 1, 1, 1, 1, 1, 1, 1, 1, 1, 1, 1, 1, 1, 1, 1, 1, 1, 0],
    [0, 1, 1, 1, 1, 1, 1, 1, 1, 1, 1, 1, 1, 1, 1, 1, 1, 1, 1, 1, 1, 0],
    [0, 1, 1, 1, 1, 1, 1, 1, 1, 1, 3, 3, 3, 1, 1, 1, 1, 1, 1, 1, 1, 0],
    [0, 1, 1, 1, 1, 1, 1, 1, 1, 1, 1, 1, 1, 1, 1, 1, 1, 1, 1, 1, 1, 0],
    [0, 0, 0, 0, 0, 0, 0, 0, 0, 0, 0, 0, 0, 0, 0, 0, 0, 0, 0, 0, 0, 0]
  ],
  "collision": [
    [1, 1, 1, 1, 1, 1, 1, 1, 1, 1, 1, 1, 1, 1, 1, 1, 1, 1, 1, 1, 1, 1],
    [1, 0, 0, 0, 0, 0, 0, 1, 1, 1, 0, 0, 0, 1, 1, 1, 0, 0, 0, 0, 0, 1],
    [1, 0, 1, 1, 1, 1, 0, 1, 1, 1, 0, 0, 0, 1, 1, 1, 0, 1, 1, 1, 0, 1],
    [1, 0, 1, 1, 1, 1, 0, 0, 1, 1, 0, 0, 0, 1, 1, 0, 0, 1, 1, 1, 0, 1],
    [1, 0, 1, 1, 1, 1, 0, 1, 1, 1, 0, 0, 0, 1, 1, 1, 0, 1, 1, 1, 0, 1],
    [1, 0, 0, 0, 0, 0, 0, 1, 1, 1, 0, 0, 0, 1, 1, 1, 0, 0, 0, 0, 0, 1],
    [1, 0, 0, 0, 0, 0, 0, 1, 1, 1, 0, 0, 0, 1, 1, 1, 0, 0, 0, 0, 0, 1],
    [1, 1, 1, 1, 1, 1, 1, 1, 1, 1, 0, 0, 0, 1, 1, 1, 1, 1, 1, 1, 1, 1],
    [1, 0, 0, 0, 0, 0, 0, 0, 0, 0, 0, 0, 0, 0, 0, 0, 0, 0, 0, 0, 0, 1],
    [1, 0, 0, 0, 0, 0, 0, 0, 0, 0, 0, 0, 0, 0, 0, 0, 0, 0, 0, 0, 0, 1],
    [1, 0, 0, 0, 0, 0, 0, 0, 0, 0, 0, 0, 0, 0, 0, 0, 0, 0, 0, 0, 0, 1],
    [1, 0, 0, 0, 0, 0, 0, 0, 0, 0, 0, 0, 0, 0, 0, 0, 0, 0, 0, 0, 0, 1],
    [1, 0, 0, 0, 0, 0, 0, 0, 0, 0, 0, 0, 0, 0, 0, 0, 0, 0, 0, 0, 0, 1],
    [1, 0, 0, 0, 0, 0, 0, 0, 0, 0, 0, 0, 0, 0, 0, 0, 0, 0, 0, 0, 0, 1],
    [1, 0, 0, 0, 0, 0, 0, 0, 0, 0, 0, 0, 0, 0, 0, 0, 0, 0, 0, 0, 0, 1],
    [1, 1, 1, 1, 1, 1, 1, 1, 1, 1, 1, 1, 1, 1, 1, 1, 1, 1, 1, 1, 1, 1]
  ],
  "npcs": [
    {
      "id": "chairman_isaka",
      "name": "井坂会長",
      "x": 4,
      "y": 3,
      "dialogue": "ようこそ。我が社の未来を担う若者よ。大いに励みたまえ。"
    },
    {
      "id": "president_umeda",
      "name": "梅田社長",
      "x": 18,
      "y": 3,
      "dialogue": "頑張ってる姿、見てますよ。期待してます！"
    },
    {
      "id": "pomekichi",
      "name": "ポメ吉",
      "x": 11,
      "y": 9,
      "dialogue": "ワンワン！（しっぽを振っている）"
    },
    {
      "id": "secretary",
      "name": "秘書",
      "x": 11,
      "y": 11,
      "dialogue": "役員の皆様は大変お忙しいので、アポイントを取ってからお越しください。"
    }
  ],
  "events": [
    {
      "type": "stairs_down",
      "x": 10,
      "y": 13,
      "destination": "jid_hq_2f.json",
      "dest_x": 9,
      "dest_y": 12
    },
    {
      "type": "stairs_down",
      "x": 11,
      "y": 13,
      "destination": "jid_hq_2f.json",
      "dest_x": 10,
      "dest_y": 12
    },
    {
      "type": "stairs_down",
      "x": 12,
      "y": 13,
      "destination": "jid_hq_2f.json",
      "dest_x": 10,
      "dest_y": 12
    }
  ]
}
