{
  "name": "JID本社 2F - 営業部フロア",
  "width": 20,
  "height": 15,
  "spawn_point": {
    "x": 10,
    "y": 12
  },
  "tiles": [
    [0, 0, 0, 0, 0, 0, 0, 0, 0, 0, 0, 0, 0, 0, 0, 0, 0, 0, 0, 0],
    [0, 1, 1, 1, 1, 1, 1, 1, 1, 0, 0, 1, 1, 1, 1, 1, 1, 1, 1, 0],
    [0, 1, 5, 5, 1, 5, 5, 1, 1, 0, 0, 1, 1, 5, 5, 1, 5, 5, 1, 0],
    [0, 1, 5, 5, 1, 5, 5, 1, 1, 2, 2, 1, 1, 5, 5, 1, 5, 5, 1, 0],
    [0, 1, 1, 1, 1, 1, 1, 1, 1, 0, 0, 1, 1, 1, 1, 1, 1, 1, 1, 0],
    [0, 1, 1, 1, 1, 1, 1, 1, 1, 0, 0, 1, 1, 1, 1, 1, 1, 1, 1, 0],
    [0, 1, 1, 4, 4, 4, 4, 1, 1, 0, 0, 1, 1, 4, 4, 4, 4, 1, 1, 0],
    [0, 1, 1, 4, 4, 4, 4, 1, 1, 0, 0, 1, 1, 4, 4, 4, 4, 1, 1, 0],
    [0, 1, 1, 4, 4, 4, 4, 1, 1, 2, 2, 1, 1, 4, 4, 4, 4, 1, 1, 0],
    [0, 1, 1, 1, 1, 1, 1, 1, 1, 0, 0, 1, 1, 1, 1, 1, 1, 1, 1, 0],
    [0, 1, 1, 1, 1, 1, 1, 1, 1, 0, 0, 1, 1, 1, 1, 1, 1, 1, 1, 0],
    [0, 1, 1, 1, 1, 1, 1, 1, 1, 0, 0, 1, 1, 1, 1, 1, 1, 1, 1, 0],
    [0, 1, 1, 1, 1, 1, 1, 1, 1, 3, 3, 1, 1, 1, 1, 1, 1, 1, 1, 0],
    [0, 1, 1, 1, 1, 1, 1, 1, 1, 0, 0, 1, 1, 1, 1, 1, 1, 1, 1, 0],
    [0, 0, 0, 0, 0, 0, 0, 0, 0, 0, 0, 0, 0, 0, 0, 0, 0, 0, 0, 0]
  ],
  "collision": [
    [1, 1, 1, 1, 1, 1, 1, 1, 1, 1, 1, 1, 1, 1, 1, 1, 1, 1, 1, 1],
    [1, 0, 0, 0, 0, 0, 0, 0, 0, 1, 1, 0, 0, 0, 0, 0, 0, 0, 0, 1],
    [1, 0, 1, 1, 0, 1, 1, 0, 0, 1, 1, 0, 0, 1, 1, 0, 1, 1, 0, 1],
    [1, 0, 1, 1, 0, 1, 1, 0, 0, 0, 0, 0, 0, 1, 1, 0, 1, 1, 0, 1],
    [1, 0, 0, 0, 0, 0, 0, 0, 0, 1, 1, 0, 0, 0, 0, 0, 0, 0, 0, 1],
    [1, 0, 0, 0, 0, 0, 0, 0, 0, 1, 1, 0, 0, 0, 0, 0, 0, 0, 0, 1],
    [1, 0, 0, 0, 0, 0, 0, 0, 0, 1, 1, 0, 0, 0, 0, 0, 0, 0, 0, 1],
    [1, 0, 0, 0, 0, 0, 0, 0, 0, 1, 1, 0, 0, 0, 0, 0, 0, 0, 0, 1],
    [1, 0, 0, 0, 0, 0, 0, 0, 0, 0, 0, 0, 0, 0, 0, 0, 0, 0, 0, 1],
    [1, 0, 0, 0, 0, 0, 0, 0, 0, 1, 1, 0, 0, 0, 0, 0, 0, 0, 0, 1],
    [1, 0, 0, 0, 0, 0, 0, 0, 0, 1, 1, 0, 0, 0, 0, 0, 0, 0, 0, 1],
    [1, 0, 0, 0, 0, 0, 0, 0, 0, 1, 1, 0, 0, 0, 0, 0, 0, 0, 0, 1],
    [1, 0, 0, 0, 0, 0, 0, 0, 0, 0, 0, 0, 0, 0, 0, 0, 0, 0, 0, 1],
    [1, 0, 0, 0, 0, 0, 0, 0, 0, 1, 1, 0, 0, 0, 0, 0, 0, 0, 0, 1],
    [1, 1, 1, 1, 1, 1, 1, 1, 1, 1, 1, 1, 1, 1, 1, 1, 1, 1, 1, 1]
  ],
  "npcs": [
    {
      "id": "sales_staff_1",
      "name": "営業スタッフA",
      "x": 3,
      "y": 5,
      "dialogue": "今日も頑張りましょう！"
    },
    {
      "id": "sales_staff_2",
      "name": "営業スタッフB",
      "x": 16,
      "y": 5,
      "dialogue": "契約目標まであと少しです！"
    },
    {
      "id": "sales_leader",
      "name": "営業リーダー",
      "x": 10,
      "y": 2,
      "dialogue": "よく来たな。気合い入れていこう！"
    }
  ],
  "events": [
    {
      "type": "stairs_up",
      "x": 9,
      "y": 12,
      "destination": "jid_hq_3f.json",
      "dest_x": 9,
      "dest_y": 2
    },
    {
      "type": "stairs_down",
      "x": 10,
      "y": 12,
      "destination": "jid_hq_1f.json",
      "dest_x": 10,
      "dest_y": 10
    }
  ]
}
